0 0 0 0 0 0 2 2 2 3 0 0 0 0 0 0
0 0 1 1 1 1 5 4 4 4 1 1 1 1 0 0
0 0 1 2 3 1 0 1 1 1 1 2 3 1 2 3
0 0 1 5 4 1 0 1 0 2 3 5 4 1 2 3
0 0 1 0 1 1 0 1 1 5 4 1 1 1 2 3
0 0 1 0 1 2 2 3 1 0 1 1 0 0 5 4
0 0 1 0 1 2 3 4 1 0 1 2 3 1 1 1
1 1 1 0 1 5 4 1 1 0 1 5 4 1 2 3
2 2 2 3 1 1 1 1 2 3 1 1 1 1 2 3
5 4 4 4 0 0 0 0 5 4 0 0 0 0 5 4