0 1 2 2 2 2 2 2 2 2 2 2 3 0 0 0
0 4 5 5 5 5 5 5 5 5 5 5 6 2 2 3
0 4 5 d a 8 8 8 8 8 b 5 5 5 5 6
0 4 5 c c 2 2 2 3 0 7 8 8 b 5 6
0 4 5 5 5 5 5 5 6 1 2 2 2 d 5 6
0 7 8 8 8 8 b 5 6 4 5 5 5 5 5 6
1 2 2 2 2 3 4 5 6 4 5 a 8 8 8 9
4 5 5 5 5 c d 5 6 4 5 c 2 2 2 2
d 5 a b 5 5 5 5 6 4 5 5 5 5 5 5
5 5 6 7 8 8 8 8 9 7 8 8 8 8 8 8