0 1 2 2 2 2 2 2 2 2 2 2 3 0 0 0
0 4 5 5 5 5 5 5 5 5 5 5 12 2 2 3
0 4 5 10 8 8 8 8 8 8 11 5 5 5 5 6
0 4 5 12 2 2 2 2 3 0 7 8 8 11 5 6
0 4 5 5 5 5 5 5 6 1 2 2 2 13 5 6
0 7 8 8 8 8 11 5 6 4 5 5 5 5 5 6
1 2 2 2 2 3 4 5 6 4 5 10 8 8 8 9
4 5 5 5 5 12 13 5 6 4 5 12 2 2 2 2
13 5 10 11 5 5 5 5 6 4 5 5 5 5 5 5
5 5 6 7 8 8 8 8 9 7 8 8 8 8 8 8