0 1 2 2 2 2 2 2 2 2 2 2 3 0 0 0
0 4 5 5 5 5 5 5 5 5 5 5 6 2 2 3
0 4 5 d a 8 8 8 8 8 b 5 5 5 5 6
0 4 5 c c 2 2 2 3 0 7 8 8 b 5 6
0 4 5 5 5 5 5 5 6 1 2 2 2 d 5 6
0 7 8 8 8 8 b 5 6 4 5 5 5 5 5 6
1 2 2 2 2 3 4 5 6 4 5 a 8 8 8 9
4 5 5 5 5 c d 5 6 4 5 c 2 2 2 2
d 5 a b 5 5 5 5 6 4 5 5 5 5 5 5
5 5 6 7 8 8 8 8 9 7 8 8 8 8 8 8

//
0 1 2 2 2 2 2 2 2 2 2 2 3 0 19 0
0 4 5 5 5 5 5 5 5 5 5 5 12 2 2 3
0 4 5 10 8 8 8 8 8 8 11 5 5 5 5 6
17 4 5 12 2 2 2 2 3 14 7 8 8 11 5 6
0 4 5 5 5 5 5 5 6 1 2 2 2 13 5 6
0 7 8 8 8 8 11 5 6 4 5 5 5 5 5 6
1 2 2 2 2 3 4 5 6 4 5 10 8 8 8 9
4 5 5 5 5 12 13 5 6 4 5 12 2 2 2 2
13 5 10 11 5 5 5 5 6 4 5 5 5 5 5 5
5 5 6 7 8 8 8 8 9 7 8 8 8 8 8 8
//
0 1 2 2 2 2 2 2 2 2 2 2 3 0 0 0
0 4 d 8 8 8 8 8 8 8 8 b 6 2 2 3
0 4 6 d a 8 8 8 8 8 b 7 8 8 b 6
0 4 6 c c 2 2 2 3 0 7 8 8 b 4 6
0 4 c 2 2 2 2 3 6 1 2 2 2 d 4 6
0 7 8 8 8 8 b 6 6 4 1 8 8 8 d 6
1 2 2 2 2 3 4 6 6 4 4 a 8 8 8 9
4 a 8 8 b c d 6 6 4 4 c 2 2 2 2
d 6 a b 7 8 8 9 6 4 7 8 8 8 8 8
5 6 6 7 8 8 8 8 9 7 8 8 8 8 8 8
//
120 760
120 600
360 600
360 680
600 680
600 360
200 360
200 120
920 120
920 200
1160 200
1160 440
840 440
840 680
1440 680
//
0 0 0 0 0 0 0 0 0 0 0 0 0 0 0 0
0 0 2 1 1 1 1 1 1 1 1 2 0 0 0 0
0 0 1 0 0 0 0 0 0 0 0 2 1 1 2 0
0 0 1 0 0 0 0 0 0 0 0 0 0 0 1 0
0 0 2 1 1 1 1 2 0 0 0 0 0 0 1 0
0 0 0 0 0 0 0 1 0 0 2 1 1 1 2 0
0 0 0 0 0 0 0 1 0 0 1 0 0 0 0 0
0 2 1 1 2 0 0 1 0 0 1 0 0 0 0 0
0 1 0 0 2 1 1 2 0 0 2 1 1 1 1 2
1 2 0 0 0 0 0 0 0 0 0 0 0 0 0 0
//
0 1 2 2 2 2 2 2 2 2 2 2 3 0 0 0
0 4 10 8 8 8 8 8 8 8 8 11 12 2 2 3
0 4 6 0 0 0 0 0 0 0 0 7 8 8 11 6
0 4 6 0 0 0 0 0 0 0 0 0 0 0 4 6
0 4 12 2 2 2 2 3 0 0 0 0 0 0 4 6
0 7 8 8 8 8 11 6 0 0 1 2 2 2 13 6
1 2 2 2 2 3 4 6 0 0 4 10 8 8 8 9
4 10 8 8 11 12 13 6 0 0 4 12 2 2 2 2
13 6 0 0 7 8 8 9 0 0 7 8 8 8 8 8
8 9 0 0 0 0 0 0 0 0 0 0 0 0 0 0
//
0 0 0 0 0 0 0 0 0 0 0 0 0 0 0 0
0 0 1 1 1 1 1 1 1 1 1 1 0 0 0 0
0 0 1 0 0 0 0 0 0 0 0 1 1 1 1 0
0 0 1 0 0 0 0 0 0 0 0 0 0 0 1 0
0 0 1 1 1 1 1 1 0 0 0 0 0 0 1 0
0 0 0 0 0 0 0 1 0 0 1 1 1 1 1 0
0 0 0 0 0 0 0 1 0 0 1 0 0 0 0 0
0 1 1 1 1 0 0 1 0 0 1 0 0 0 0 0
0 1 0 0 1 1 1 1 0 0 1 1 1 1 1 1
1 1 0 0 0 0 0 0 0 0 0 0 0 0 0 0
//

2 3 0 0 0 0 0 0 0 0 0 0 2 2 2 0
2 3 1 1 1 1 1 1 1 1 1 1 5 5 5 0
2 3 1 2 2 2 2 2 2 2 3 1 1 1 1 0
2 3 1 5 4 4 4 4 2 2 2 2 2 3 1 0
2 3 1 1 1 1 1 1 2 3 4 4 4 4 1 0
2 2 2 2 2 2 3 1 2 3 1 1 1 1 1 0
5 4 4 4 4 2 3 1 2 3 1 2 2 2 2 3
0 1 1 1 1 5 4 1 2 3 1 5 4 4 4 4
0 1 2 3 1 1 1 1 2 3 1 1 1 1 1 1
1 1 5 4 0 0 0 0 5 4 0 0 0 0 0 0